  @@@@@ 
 @@@@@@ 
@@@@@@@@
@@@@@@@@
@@@@@@@@
@@@@@@@@
 @@@@@@ 