    @
  @@@@  
  @@@@@
 @@@@@  
 @@@@@@ 
@@@@@@@@
 @@@@@@@@
@@@@@@@@@